AAAAAAAAAAAAAAAAAAAAAAAAAAAAAA
AAAAAAAAAAAAAAAAAAAAAAAAAAAAAA
AAAAAAAAAAAAAAAAAAAAAAAAAAAAAA
AAAAAAAAAAAAAAAAAAAAAAAAAAAAAA
AAAAAAAAAAAAAAAAAAAAAA       A
AAAAAAAAAAAAAAAAAAAAAA       A
AAAAAAAAAAA       AAAAXXX    A
AAAAAAAAAAA       AAAAAAA    A
AAAAAAAAAAA                  A
AAAAAAA       A              A
AAAAAAA       A              A
AAAAAAAAAAAAAAAAAAAAAAAAAAAAAA