AAAAAAAAAAAAAAAAAAAAAAAAAAAAAAAAAAAAAAA
AAAAAAAAAAAAAAAAAAAAAAAAAAAAAAAAAAAAAAA
AAAAAAAAAAAAAAAAAAAAAAAAAAAAAAAAAAAAAAA
AAAAAAAAAAAAAAAAAAAAAAAAAAAAAAAAAAAAAAA
AAAAAAAAAAAAAAAAAAAAAAAAAAAAAAAAAAAAAAA
AAAAAAAAAAAAAAAAAAAAAAAAAAAAAAAAAAAAAAA
AAAAAAAAAAAAAAAAAAAAAAAAAAAAAAAAAAAAAAA
AAAAAAAAAAAAAAAAAAAAAAAAAAAAAAAAAAAAAAA
AAAAAAA    AAAAAAAAAAAA        A      A
AAAAAAA    AAAAAAAAAAAA    A  AA      A
AAAAAAAAA  A       AAAA    A   A      A
AAAAAAAAA          AAAA    AA  A      A
AAAAAAA            AAAA    A   A      A
AAAAAAA      X  A  AAAA    A  AA      A
AAAAAAAAAAAAAAAAA  AAAA    A   A      A
AAAAAAAAAAAAAAAAA  AAAA    AA  A      A
AAAAAAAAAAAAAAAAA  AAA     A   A  AA  A
AAAAAAAAAAAAAAAAA  AA      A  AA      A
AAAAAAAAAAAAAAAAA  A      AA   A      A
AAAAAAAAAAAAAAAAA  A     AAA   A      A
AAAAAAAAAAAAAAAAA       AAAA   A      A
AAAAAAAAAAAAAAAAA      AAAAA          A
AAAAAAAAAAAAAAAAA     AAAAAA          A
AAAAAAAAAAAAAAAAAAAAAAAAAAAAAAAAAAAAAAA
AAAAAAAAAAAAAAAAAAAAAAAAAAAAAAAAAAAAAAA
AAAAAAAAAAAAAAAAAAAAAAAAAAAAAAAAAAAAAAA
AAAAAAAAAAAAAAAAAAAAAAAAAAAAAAAAAAAAAAA
AAAAAAAAAAAAAAAAAAAAAAAAAAAAAAAAAAAAAAA